25 25
100 100
4 10 10 10 10 10 10 10 10 10 10 10 10 10 10 10 10 10 10 10 10 10 10 10 5
8 1  1  1  1  1  3  1  1  1  1  1  1  1  3  1  1  1  1  1  1  1  1  1  9
8 1  1  1  3  1  3  1  3  3  3  1  3  1  3  1  3  3  3  3  3  1  3  3  9
8 1  1  1  3  1  3  1  3  1  3  1  3  1  1  1  3  1  1  1  1  1  1  1  9
8 3  3  3  3  1  3  1  3  1  3  1  3  1  3  3  3  1  3  3  3  3  3  3  9
8 1  1  1  1  1  3  1  1  1  3  1  3  1  3  1  1  1  3  1  1  3  1  1  9
8 1  3  3  3  3  3  3  3  3  3  1  3  3  3  1  3  3  3  1  3  3  3  1  9
8 1  1  1  1  1  1  1  1  1  3  1  3  1  3  1  3  1  1  1  1  1  1  1  9
8 1  3  3  3  3  3  3  3  1  3  1  3  1  3  1  3  3  3  1  3  3  3  3  9
8 1  1  1  1  1  1  1  3  1  3  1  3  1  3  1  1  1  3  1  1  1  1  1  9
8 3  3  1  3  3  3  1  3  1  3  1  3  1  3  3  3  1  3  3  3  3  3  1  9
8 1  3  1  1  1  3  1  3  1  1  1  3  1  1  1  1  1  3  1  1  1  1  1  9
8 1  3  1  3  1  3  1  3  3  3  3  3  1  3  3  3  1  3  1  3  3  3  1  9
8 1  1  1  3  1  3  1  1  1  1  1  3  1  1  1  3  1  1  1  3  1  3  1  9
8 3  3  3  3  1  3  1  3  3  3  3  3  1  3  1  3  3  3  3  3  1  3  1  9
8 1  1  1  1  1  3  1  3  1  1  1  1  1  3  1  1  1  1  1  1  1  3  1  9
8 3  3  1  3  3  3  1  3  1  3  3  3  3  3  3  3  3  3  1  3  3  3  1  9
8 1  1  1  3  1  1  1  3  1  1  1  1  1  1  1  3  1  1  1  1  1  3  1  9
8 1  3  3  3  3  3  3  3  3  3  3  3  1  3  3  3  1  3  1  3  3  3  1  9
8 1  3  1  1  1  1  1  3  1  3  1  1  1  1  1  3  1  3  1  3  1  1  1  9
8 1  3  1  3  3  3  3  3  1  3  1  3  3  3  3  3  1  3  3  3  1  3  3  9
8 1  3  1  1  1  1  1  3  1  3  1  1  1  1  1  3  1  1  1  3  1  3  13 9
8 1  3  3  3  3  3  1  3  1  3  1  3  3  3  3  3  3  3  1  3  1  3  13 9
8 1  1  1  1  1  1  1  3  1  1  1  1  1  1  1  1  1  3  1  1  1  1  1  9
7 11 11 11 11 11 11 11 11 11 11 11 11 11 11 11 11 11 11 11 11 11 11 11 6